0 0 0 0 0 0 0 0 0 
1 1 3 5 7 9 11 13 15 
2 2 4 6 8 10 12 14 16 
3 3 5 7 9 11 13 15 17 
4 4 6 8 10 12 14 16 18 
5 5 7 9 11 13 15 17 19 
6 6 8 10 12 14 16 18 20 
7 7 9 11 13 15 17 19 21 
8 8 10 12 14 16 18 20 22 
9 9 11 13 15 17 19 21 23 
10 10 12 14 16 18 20 22 24 
11 11 13 15 17 19 21 23 25 
12 12 14 16 18 20 22 24 26 
13 13 15 17 19 21 23 25 27 
14 14 16 18 20 22 24 26 28 
15 15 17 19 21 23 25 27 29 
16 16 18 20 22 24 26 28 30 
17 17 19 21 23 25 27 29 31 
18 18 20 22 24 26 28 30 32 
19 19 21 23 25 27 29 31 33 
20 20 22 24 26 28 30 32 34 
21 21 23 25 27 29 31 33 35 
22 22 24 26 28 30 32 34 36 
23 23 25 27 29 31 33 35 37 
24 24 26 28 30 32 34 36 38 
25 25 27 29 31 33 35 37 39 
26 26 28 30 32 34 36 38 40 
27 27 29 31 33 35 37 39 41 
28 28 30 32 34 36 38 40 42 
29 29 31 33 35 37 39 41 43 
30 30 32 34 36 38 40 42 44 
31 31 33 35 37 39 41 43 45 
32 32 34 36 38 40 42 44 46 
33 33 35 37 39 41 43 45 47 
34 34 36 38 40 42 44 46 48 
35 35 37 39 41 43 45 47 49 
36 36 38 40 42 44 46 48 50 
37 37 39 41 43 45 47 49 51 
38 38 40 42 44 46 48 50 52 
39 39 41 43 45 47 49 51 53 
40 40 42 44 46 48 50 52 54 
41 41 43 45 47 49 51 53 55 
42 42 44 46 48 50 52 54 56 
43 43 45 47 49 51 53 55 57 
44 44 46 48 50 52 54 56 58 
45 45 47 49 51 53 55 57 59 
46 46 48 50 52 54 56 58 60 
47 47 49 51 53 55 57 59 61 
48 48 50 52 54 56 58 60 62 
49 49 51 53 55 57 59 61 63 
50 50 52 54 56 58 60 62 64 
51 51 53 55 57 59 61 63 65 
52 52 54 56 58 60 62 64 66 
53 67 67 67 67 67 67 67 67 
54 68 68 68 68 68 68 68 68 
55 69 69 69 69 69 69 69 69 
56 70 70 70 70 70 70 70 70 
57 71 71 71 71 71 71 71 71 
58 72 72 72 72 72 72 72 72 
59 73 73 73 73 73 73 73 73 
60 74 74 74 74 74 74 74 74 
61 75 75 75 75 75 75 75 75 
62 76 76 76 76 76 76 76 76 
63 77 77 77 77 77 77 77 77 
64 78 78 78 78 78 78 78 78 
65 79 79 79 79 79 79 79 79 
66 80 80 80 80 80 80 80 80 
67 81 81 81 81 81 81 81 81 
68 82 82 82 82 82 82 82 82 
69 83 83 83 83 83 83 83 83 
70 84 84 84 84 84 84 84 84 
71 85 85 85 85 85 85 85 85 
72 86 86 86 86 86 86 86 86 
73 87 87 87 87 87 87 87 87 
74 88 88 88 88 88 88 88 88 
75 89 89 89 89 89 89 89 89 
76 90 90 90 90 90 90 90 90 
77 91 91 91 91 91 91 91 91 
78 92 92 92 92 92 92 92 92 
79 93 93 93 93 93 93 93 93 
80 94 94 94 94 94 94 94 94 
81 95 95 95 95 95 95 95 95 
82 96 96 96 96 96 96 96 96 
83 97 97 97 97 97 97 97 97 
84 98 98 98 98 98 98 98 98 
85 99 99 99 99 99 99 99 99 
86 100 100 100 100 100 100 100 100 
87 101 101 101 101 101 101 101 101 
88 102 102 102 102 102 102 102 102 
89 103 103 103 103 103 103 103 103 
90 104 104 104 104 104 104 104 104 
91 105 105 105 105 105 105 105 105 
92 106 106 106 106 106 106 106 106 
93 107 107 107 107 107 107 107 107 
94 108 108 108 108 108 108 108 108 
95 109 109 109 109 109 109 109 109 
96 110 110 110 110 110 110 110 110 
97 111 111 111 111 111 111 111 111 
98 112 112 112 112 112 112 112 112 
99 113 113 113 113 113 113 113 113 
100 114 114 114 114 114 114 114 114 
101 115 115 115 115 115 115 115 115 
102 116 116 116 116 116 116 116 116 
103 0 2 4 6 8 10 12 14 
104 1 3 5 7 9 11 13 15 
